moku Jupesi (toki Nijon la: ゆべし) li moku suwi pi ma Nijon (ma Ukusima).


== moku ==


=== moku lili ===

pan Potamosi (toki Nijon la: ぼたもち, Botamochi)
pan Tawipuku (toki Nijon la: 大福, Daifuku)
kili Etamame (toki Nijon la: 枝豆, Edamame)
pan Okonomijaki (toki Nijon la: お好み焼き, Okonomiyaki)
pan Tawijaki (toki Nijon la: たい焼き, Taiyaki)
pan Takojaki (toki Nijon la: たこ焼き, Takoyaki)


=== moku suwi ===

suwi Amesawiku (toki Nijon la: 飴細工, Amezaiku)
suwi Anisu (toki Nijon la: あんみつ, Anmitsu)
pan Anpan (toki Nijon la: あんパン, Anpan)
pan Kasutela (toki Nijon la: カステラ, Kasutera)
pan Sinsuko (toki Nijon la: ちんすこう, Chinsukō)
suwi Masa Awisukulimu (toki Nijon la: 抹茶アイスクリーム, Matcha aisukurīmu)
pan Imakawajaki (toki Nijon la: 今川焼き, Imagawayaki)
pan Melonpan (toki Nijon la: メロンパン, Meronpan)
suwi Mosi Ajisu (toki Nijon la: 餅アイス, Mochi aisu)
pan Momisi Mansu (toki Nijon la: もみじ饅頭, Momiji manjū)
suwi Pulin (toki Nijon la: プリン, Purin)
suwi Misusinkenmosi (toki Nijon la: 水信玄餅, Mizushingenmochi)
pan Sata Antaki (toki Nijon la: サーターアンダーギー, Sātā andāgī)
suwi Wakasi (toki Nijon la: 和菓子, Wagashi)


=== moku suli ===

moku Susi (toki Nijon la: 寿司, Sushi)
moku Sasimi (toki Nijon la: 刺身, Sashimi)
kili Unaki (toki Nijon la: うなぎ, Unagi)
pan Tenpula (toki Nijon la: 天ぷら, Tempura)
pan Sopa (toki Nijon la: 蕎麦, Soba)
moku Uton (toki Nijon la: うどん, Udon)
pan Lamen (toki Nijon la: ラーメン, Ramen)
pan Onikili (toki Nijon la: おにぎり, Onigiri)
moku Jakitoli (toki Nijon la: 焼き鳥, Yakitori)
moku Sukijaki (toki Nijon la: すき焼き, Sukiyaki)