toki Olapi (anu; Volap端k, IPA: /volapyk/) li toki sin. jan pali ona li jan Jojan Masin Saja (Johann Martin Schleyer). ona li pali e toki Olapi lon tenpo 1879.

toki sin ni li pali tawa jan ale. kulupu tomo Kadem bev端netik volap端ka (tomo lawa pi toki Olapi tan ma ale) li misikeke e ona.
tenpo lon la, jan 20 (noka) li toki e toki ni. tenpo pini la, sama jan 200,000 li toki e toki Olapi. taso, tan tenpo 1889 la, jan lili mute li kama sona e toki ni.

toki Epelanto en toki pona la, toki Olapi li pona ala. ona li wile e tenpo ilo suli 350~, taso toki Epelanto wile e tenpo ilo suli 150~, en toki pona wile e 30~.

kalama ale lon toki Olapi:


== nimi ==
nimi ijo

vol - ma
p端k - toki
staf - palisa
fluk - kili
her - linja lawa
fut - noka anpa
nim - soweli
bim - kasi suli
sid - ijo sike lili pi kama kasi
ston - kiwen

nimi tawa ijo/jan

ob - mi
obs - mi mute
ol - sina
ols - sina mute
om - ona (mije)
oms - ona (mije ale)
of - ona (meli)
ofs - ona (meli ale)
on - ona (tonsi, anu kon ala)
ons - ona (tonsi, anu kon ala)
ok/oks - nimi tawa jan toki (sama nimi "mi", taso nimi ni li ante.)
od/ods - nimi tawa jan ante
oy - nimi tawa jan ale
os - ijo ala
or - nasin sewi pi nimi "ol" (kepeken lon toki Olapi sin taso, lili kin)
ors - nasin sewi pi nimi "ols" (kepeken lon toki Olapi sin taso, lili kin)


== "jan meli o" lon toki Olapi ==